11111111111111111111111111111111111111111111111111111111111111111111111111111111111111111111111111111111111111111111111111111111111111111111111111111111111111111111111111
1E0000000000000C00000C000000000000000000000000C00000C000000000000000000000000C00000C000000000000000000000000C00000C000000000000000000000000C00000C00000000000C00000C000001
1010010100100000101001000000010101001010010000010100100000001010100101001000001010010000000101010010100100000101001000000010101001010010000010100100000001010C00000C000001
1010010010101010001001000000010101001001010101000100100000001010100100101010100010010000000101010010010101010001001000000010101001001010101000100100000001010C00000C000001
1P0000000C00C0000000000000000000C0000000C00C0000000000000000000C0000000C00C0000000000000000000C0000000C00C0000000000000000000C0000000C00C0000000000000000000CC00000C000001
11111111111111111111111111111111111111111111111111111111111111111111111111111111111111111111111111111111111111111111111111111111111111111111111111111111111111111111111111
11111111111111111111111111111111111111111111111111111111111111111111111111111111111111111111111111111111111111111111111111111111111111111111111111111111111111111111111111
100000000000000C00000C000000000000000000000000C00000C000000000000000000000000C00000C000000000000000000000000C00000C000000000000000000000000C00000C00000000000C00000C000001
1010010100100000101001000000010101001010010000010100100000001010100101001000001010010000000101010010100100000101001000000010101001010010000010100100000001010C00000C000001
1010010010101010001001000000010101001001010101000100100000001010100100101010100010010000000101010010010101010001001000000010101001001010101000100100000001010C00000C000001
100000000C00C0000000000000000000C0000000C00C0000000000000000000C0000000C00C0000000000000000000C0000000C00C0000000000000000000C0000000C00C0000000000000000000CC00000C000001
11111111111111111111111111111111111111111111111111111111111111111111111111111111111111111111111111111111111111111111111111111111111111111111111111111111111111111111111111
11111111111111111111111111111111111111111111111111111111111111111111111111111111111111111111111111111111111111111111111111111111111111111111111111111111111111111111111111
100000000000000C00000C000000000000000000000000C00000C000000000000000000000000C00000C000000000000000000000000C00000C000000000000000000000000C00000C00000000000C00000C000001
1010010100100000101001000000010101001010010000010100100000001010100101001000001010010000000101010010100100000101001000000010101001010010000010100100000001010C00000C000001
1010010010101010001001000000010101001001010101000100100000001010100100101010100010010000000101010010010101010001001000000010101001001010101000100100000001010C00000C000001
100000000C00C0000000000000000000C0000000C00C0000000000000000000C0000000C00C0000000000000000000C0000000C00C0000000000000000000C0000000C00C0000000000000000000CC00000C000001
11111111111111111111111111111111111111111111111111111111111111111111111111111111111111111111111111111111111111111111111111111111111111111111111111111111111111111111111111
11111111111111111111111111111111111111111111111111111111111111111111111111111111111111111111111111111111111111111111111111111111111111111111111111111111111111111111111111
100000000000000C00000C000000000000000000000000C00000C000000000000000000000000C00000C000000000000000000000000C00000C000000000000000000000000C00000C00000000000C00000C000001
1010010100100000101001000000010101001010010000010100100000001010100101001000001010010000000101010010100100000101001000000010101001010010000010100100000001010C00000C000001
1010010010101010001001000000010101001001010101000100100000001010100100101010100010010000000101010010010101010001001000000010101001001010101000100100000001010C00000C000001
100000000C00C0000000000000000000C0000000C00C0000000000000000000C0000000C00C0000000000000000000C0000000C00C0000000000000000000C0000000C00C0000000000000000000CC00000C000001
11111111111111111111111111111111111111111111111111111111111111111111111111111111111111111111111111111111111111111111111111111111111111111111111111111111111111111111111111
11111111111111111111111111111111111111111111111111111111111111111111111111111111111111111111111111111111111111111111111111111111111111111111111111111111111111111111111111
100000000000000C00000C000000000000000000000000C00000C000000000000000000000000C00000C000000000000000000000000C00000C000000000000000000000000C00000C00000000000C00000C000001
1010010100100000101001000000010101001010010000010100100000001010100101001000001010010000000101010010100100000101001000000010101001010010000010100100000001010C00000C000001
1010010010101010001001000000010101001001010101000100100000001010100100101010100010010000000101010010010101010001001000000010101001001010101000100100000001010C00000C000001
100000000C00C0000000000000000000C0000000C00C0000000000000000000C0000000C00C0000000000000000000C0000000C00C0000000000000000000C0000000C00C0000000000000000000CC00000C000001
11111111111111111111111111111111111111111111111111111111111111111111111111111111111111111111111111111111111111111111111111111111111111111111111111111111111111111111111111
11111111111111111111111111111111111111111111111111111111111111111111111111111111111111111111111111111111111111111111111111111111111111111111111111111111111111111111111111
100000000000000C00000C000000000000000000000000C00000C000000000000000000000000C00000C000000000000000000000000C00000C000000000000000000000000C00000C00000000000C00000C000001
1010010100100000101001000000010101001010010000010100100000001010100101001000001010010000000101010010100100000101001000000010101001010010000010100100000001010C00000C000001
1010010010101010001001000000010101001001010101000100100000001010100100101010100010010000000101010010010101010001001000000010101001001010101000100100000001010C00000C000001
100000000C00C0000000000000000000C0000000C00C0000000000000000000C0000000C00C0000000000000000000C0000000C00C0000000000000000000C0000000C00C0000000000000000000CC00000C000001
11111111111111111111111111111111111111111111111111111111111111111111111111111111111111111111111111111111111111111111111111111111111111111111111111111111111111111111111111
11111111111111111111111111111111111111111111111111111111111111111111111111111111111111111111111111111111111111111111111111111111111111111111111111111111111111111111111111
100000000000000C00000C000000000000000000000000C00000C000000000000000000000000C00000C000000000000000000000000C00000C000000000000000000000000C00000C00000000000C00000C000001
1010010100100000101001000000010101001010010000010100100000001010100101001000001010010000000101010010100100000101001000000010101001010010000010100100000001010C00000C000001
10100100101010100010010000000101010010010101010001001000000010101001001010101000C0010000000101010010010101010001001000000010101001001010101000100100000001010C00000C000001
100000000C00C0000000000000000000C0000000C00C0000000000000000000C0000000C00C0000000000000000000C0000000C00C0000000000000000000C0000000C00C0000000000000000000CC00000C000001
11111111111111111111111111111111111111111111111111111111111111111111111111111111111111111111111111111111111111111111111111111111111111111111111111111111111111111111111111
11111111111111111111111111111111111111111111111111111111111111111111111111111111111111111111111111111111111111111111111111111111111111111111111111111111111111111111111111
100000000000000C00000C000000000000000000000000C00000C000000000000000000000000C00000C000000000000000000000000C00000C000000000000000000000000C00000C00000000000C00000C000001
1010010100100000101001000000010101001010010000010100100000001010100101001000001010010000000101010010100100000101001000000010101001010010000010100100000001010C00000C000001
1010010010101010001001000000010101001001010101000100100000001010100100101010100010010000000101010010010101010001001000000010101001001010101000100100000001010C00000C000001
100000000C00C0000000000000000000C0000000C00C0000000000000000000C0000000C00C0000000000000000000C0000000C00C0000000000000000000C0000000C00C0000000000000000000CC00000C000001
11111111111111111111111111111111111111111111111111111111111111111111111111111111111111111111111111111111111111111111111111111111111111111111111111111111111111111111111111
11111111111111111111111111111111111111111111111111111111111111111111111111111111111111111111111111111111111111111111111111111111111111111111111111111111111111111111111111
100000000000000C00000C000000000000000000000000C00000C000000000000000000000000C00000C000000000000000000000000C00000C000000000000000000000000C00000C00000000000C00000C000001
1010010100100000101001000000010101001010010000010100100000001010100101001000001010010000000101010010100100000101001000000010101001010010000010100100000001010C00000C000001
1010010010101010001001000000010101001001010101000100100000001010100100101010100010010000000101010010010101010001001000000010101001001010101000100100000001010C00000C000001
100000000C00C0000000000000000000C0000000C00C0000000000000000000C0000000C00C0000000000000000000C0000000C00C0000000000000000000C0000000C00C0000000000000000000CC00000C000001
11111111111111111111111111111111111111111111111111111111111111111111111111111111111111111111111111111111111111111111111111111111111111111111111111111111111111111111111111
11111111111111111111111111111111111111111111111111111111111111111111111111111111111111111111111111111111111111111111111111111111111111111111111111111111111111111111111111
100000000000000C00000C000000000000000000000000C00000C000000000000000000000000C00000C000000000000000000000000C00000C000000000000000000000000C00000C00000000000C00000C000001
1010010100100000101001000000010101001010010000010100100000001010100101001000001010010000000101010010100100000101001000000010101001010010000010100100000001010C00000C000001
1010010010101010001001000000010101001001010101000100100000001010100100101010100010010000000101010010010101010001001000000010101001001010101000100100000001010C00000C000001
100000000C00C0000000000000000000C0000000C00C0000000000000000000C0000000C00C0000000000000000000C0000000C00C0000000000000000000C0000000C00C0000000000000000000CC00000C000001
11111111111111111111111111111111111111111111111111111111111111111111111111111111111111111111111111111111111111111111111111111111111111111111111111111111111111111111111111
11111111111111111111111111111111111111111111111111111111111111111111111111111111111111111111111111111111111111111111111111111111111111111111111111111111111111111111111111
100000000000000C00000C000000000000000000000000C00000C000000000000000000000000C00000C000000000000000000000000C00000C000000000000000000000000C00000C00000000000C00000C000001
1010010100100000101001000000010101001010010000010100100000001010100101001000001010010000000101010010100100000101001000000010101001010010000010100100000001010C00000C000001
1010010010101010001001000000010101001001010101000100100000001010100100101010100010010000000101010010010101010001001000000010101001001010101000100100000001010C00000C000001
100000000C00C0000000000000000000C0000000C00C0000000000000000000C0000000C00C0000000000000000000C0000000C00C0000000000000000000C0000000C00C0000000000000000000CC00000C000001
11111111111111111111111111111111111111111111111111111111111111111111111111111111111111111111111111111111111111111111111111111111111111111111111111111111111111111111111111
