1111111111111111111111111111111111
10000000000001E000000C000000000001
1010010100100111100100000001010111
1010010010101010001001000000010101
1P0000000C00C00000000000C000000001
1111111111111111111111111111111111
