1111111111111111111111111111111111
10000000000001E100000C000000000001
1010010100100111100100000001010111
1010010010101010001001000000010101
1P0000000C00C0000000000000000000C1
1111111111111111111111111111111111
