11111111111111111111
100000000001000000C1
10000000000000011001
10000001000000100111
10000000000000C00001
101000000000E0000001
10000000000000000001
11010000C0000C000001
10000001000100000001
101C0000001000000C01
1000000001C000001011
1000001000001100C001
100C0000100000000001
100C1000000000000001
10000010000000000001
1000100C001100000001
10000100000000000001
10000C00000P00000001
11000C0C001001000001
11111111111111111111
