1111111111
1000000001
1010000001
1000000001
1C10000001
1000000001
10000000C1
100P000001
10000E0001
1111111111
